########
#      #
#      #
# .. p #
# oo   #
#      #
########