########
#      #
#  op#o#
#.   #.#
########